NO ./texture/no.xpm
EA ./texture/ea.xpm
SO ./texture/so.xpm
WE ./texture/we.xpm

F 0,0,255
C 255,255,0

1111111111
1000000001
1000000001
10000S0001
1001000101
1000000001
1111111111