NO ./texture/no.xpm
EA ./texture/ea.xpm
SO ./texture/so.xpm
WE ./texture/we.xpm

F 255,255,255
C 255,255,255

111111111111
100000000001
100000000001
100000N00001
100000000001
100000000001
111111111111