NO ./texture/no.xpm
SO ./texture/so.xpm
EA ./texture/ea.xpm
WE ./texture/we.xpm

F 110,153,15
C 255,255,0

1111111
1000001
100N001
100A001
1000001
1112111
