NO ./texture/no.xpm
EA ./texture/ea.xpm
SO ./texture/so.xpm
WE ./texture/we.xpm

F 184,113,243
C 51,12,227

111111
100001
100E01
100001
111111