NO ./texture/no.xpm
EA ./texture/ea.xpm
SO ./texture/so.xpm
WE ./texture/we.xpm
C 255,255,0
F 0,0,0

11111
10001
10W01
10001
11111