NO ./texture/no.xpm
EA ./texture/ea.xpm
SO ./texture/so.xpm
WE ./texture/we.xpm

F 0,0,255
C 255,255,0

11111
10101
10N01
10001
11111