NO ./texture/no.xpm
SO ./texture/so.xpm
EA ./texture/ea.xpm
WE ./texture/we.xpm

F 110,153,15
C 255,255,0

11111          
10001       
100201       
100011111111111111111111
11111       