NO ./texture/no.xpm
EA ./texture/ea.xpm
SO ./texture/so.xpm
WE ./texture/we.xpm


F 0,0,125
C 0,0,125

111111
100001
100E01
100001
111111