NO ./texture/no.xpm
SO ./texture/so.xpm
EA ./texture/ea.xpm
WE ./texture/we.xpm

F 1,1,1
F 2,2,2
C 110,110,110

111111
100001
100E01
100001
111111