NO ./texture/no.xpm
EA ./texture/ea.xpm
SO ./texture/so.xpm
WE ./texture/we.xpm

F 25,25,25
C 0,0,0

111111111111
100000000001
101000001001
100000N00001
101000001001
100000000001
111111111111